SO ./assets/RETRO_TEXTURE_PACK_V15/TEXTURES/BRICK_3A.PNG
NO ./assets/RETRO_TEXTURE_PACK_V15/TEXTURES/BRICK_3B.PNG
WE ./assets/RETRO_TEXTURE_PACK_V15/TEXTURES/BRICK_6B.PNG
EA ./assets/RETRO_TEXTURE_PACK_V15/TEXTURES/BRICK_6C.PNG

F 0,100,0
C 0,0,200

    
           1111111111111111111111111111111111
           1000000000110000000000000001100101
           1011000011110000001000000001000101
           1001000000000000000100010000000001
111111111111000001110000000000001110111111111
100000000011000001110101101111111 1011
11110111111111011100000010001     1001
11110111111111011101010010001     1001
11000000110101011100000010001     1001
10000000000000001100000010001     1111
10111000000000001101010010001
11000001110101011111011110N0111
11110111 1110101 101111010001
11111111 1111111 111111111111