NO ./assets/duck1.png
SO ./assets/duck1.png
WE ./assets/duck1.png
EA ./assets/duck1.png


F 220,100,0
C 225,30,0

111111111111111111111111111111111111111   
111111111111111111111111111111111111111
110000000000000000000000000000000000011
110000000000000000000000000000000000011
110000000000000000000000000000000000011
110000000000000000000000000000000000011
110000000000000000000000000000000000011
110000000000000000000000000000000000011
110000000000000000000000000000000000011
110000000000000000000000000000000000011
110000000000000000000000000000000000011
110000000000000000000000000000000000011
110000000000000000000000000000000000011
110000000000000000000000000000000000011
110000000000000000000000000000000000011
110000000000000000000000000000000000011
110000000000000000000000000000000000011
110000000000000000000000000000000000011
110000000000000000000000000000000000011
110000000000000000000000000000000000011
110000000000000000000000000000000000011
110000000000000000000000000000000000011
110000000000000000000000000000000000011
110000000000000000000000000000000000011
110000000000000000000111111111111111111
11000000000000000000011
11001110011111111111111
110N1110011
11001110011
11000000011
11111111111
11111111111