NO ./assets/BRICK_3B.PNG
SO ./assets/BRICK_3D.PNG
WE ./assets/BRICK_4A.PNG
EA ./assets/BRICK_6D.PNG


F 0,100,0
C 0,0,200

    
           111111111111111111111111
           1000000000110000000000001
           1011000011110000000000001
           1001000000000000000000001
111111111111000001110000000000001111
100000000011000001110101101111111
11110111111111011100000010001
11110111111111011101010010001
11000000110101011100000010001
10000000000000001100000010001
10000000000000001101010010001
11000001110101011111011110W0111
11110111 1110101 101111010001
11111111 1111111 111111111111