NO ./assets/BRICK_3B.PNG
SO ./assets/BRICK_3D.PNG
WE ./assets/BRICK_4A.PNG
EA ./assets/BRICK_6D.PNG


F 220,100,0
C 225,30,0

11111111111
11111111111
11000400011
11000400011
11000000011
11000400011
11000N00011
11111111111
11111111111