NO ./assets/BRICK_3B.PNG
SO ./assets/BRICK_3D.PNG
WE ./assets/BRICK_4A.PNG
EA ./assets/BRICK_6D.PNG

BF ./assets/floor_lava.png
BC ./assets/floor_02.png
DO ./assets/Door03.png
BS ./assets/steel_cage2.png

F 0,0,0
C 25,30,0

11111111111
11111111111
11000000011
11000000011
11000000011
11000400011
11000N00011
11111111111
11111111111