NO ./assets/kenney_prototypeTextures/PNG/Purple/texture_10.png
SO ./assets/kenney_prototypeTextures/PNG/Orange/texture_10.png
WE ./assets/kenney_prototypeTextures/PNG/Red/texture_10.png
EA ./assets/kenney_prototypeTextures/PNG/Green/texture_10.png

BF ./assets/kenney_prototypeTextures/PNG/Dark/texture_08.png
BC ./assets/kenney_prototypeTextures/PNG/Light/texture_05.png
DO ./assets/kenney_prototypeTextures/PNG/Light/texture_10.png
BS ./assets/kenney_prototypeTextures/PNG/Light/texture_11.png

F 0,100,0
C 0,0,200

    
           111111111111111111111111111111111111111
           100000000011044000000000000000114000141
           101100001111000000140000000000100000121
           104100002000000000010000001000000000001
11111111111100000111000000000000111111211111111111
140000000411000001112121121111111    1011
11110111111111011100000010001        1001
11112111111111211101010010401        1001
11000000110101011100000010001        1041
10000000000000001100400010001        1111
10111000000000001141010010001
11400001110101011111011110N0111
11110111 1110101 101111010001
11111111 1111111 111111111111