SO ./assets/RETRO_TEXTURE_PACK_V15/TEXTURES/BRICK_4C.PNG
NO ./assets/RETRO_TEXTURE_PACK_V15/TEXTURES/BRICK_4C.PNG
WE ./assets/RETRO_TEXTURE_PACK_V15/TEXTURES/BRICK_4D.PNG
EA ./assets/RETRO_TEXTURE_PACK_V15/TEXTURES/BRICK_4D.PNG

BF ./assets/RETRO_TEXTURE_PACK_V15/TEXTURES/GRASS_1A.PNG
BC ./assets/tile002.png
DO ./assets/RETRO_TEXTURE_PACK_V15/TEXTURES/BIGDOOR_1A.PNG
BS ./assets/RETRO_TEXTURE_PACK_V15/TEXTURES/CRATE_3B.PNG

F 0,100,0
C 40,40,230

    
           1111111111111111111111111111111111
           1000000000110440000000000001140141
           1011000011110000001400000001000121
           1041000020000000000100010000000001
111111111111000001110000000000001112111111111
140000000411000001112121121111111 1011
11110111111111011100000010001     1001
11112111111111211101010010401     1001
11000000110101011100000010001     1041
10000000000000001100400010001     1111
10111000000000001141010010001
11400001110101011111011110N0111
11110111 1110101 101111010001
11111111 1111111 111111111111